[
  [
    "w . . . . . . . . . . . . . . .",
    ". l . . . . . . . . . . . . . .",
    ". . p . . . . . . . . . l . . .",
    ". . . . . m . . . . . . . . . .",
    ". . . . . . . . . . . . . . . .",
    ". . . . . . . . . . . . . . . .",
    ". . . . . . . . w w w w w w w .",
    ". . . . . . . . w . . . . . w .",
    ". . . w w w w w w . . O . . w .",
    ". . . . . . . . . . . . . . w .",
    ". . . . . . . . . . . . . . w .",
    ". u u . . . . . w w w w w w w .",
    ". . . . . . . . . . . . . . . .",
    ". . . . . . . . . . . . . . . .",
    ". . . . . . . . . . . . . . . .",
    ". . . . . . . . . . . . . . . ."
  ],
  [
    "w . . w . . . . . . . . . . . .",
    ". . . w . . . . . . . . . . . .",
    ". . . w . w w w w w w w w w . .",
    ". . . w . . . . . . . . l . w .",
    ". . . w w w w w w w w . . w . .",
    ". . . . . . . . . w . l . w . .",
    ". . . . . . . . . . w . . w . .",
    ". . . . . . . . . . w . . w . .",
    ". . . . . . . . . . w O . w . .",
    ". . . . . . . . . . w w w w . .",
    ". . . . . . . . . . . . . . . .",
    ". . . . . . . . . . . . . . . .",
    ". . . . . . . . . . . . . . . .",
    ". . . . p . . . . . . . . . . .",
    ". . . . . . . . . . . . . . . .",
    ". . . . . . . . . . . . . . . ."
  ],
  [
    "w w w . . . . . . . . . .",
    "w o w . . . . . . . . . .",
    "w . w w w w w w w w w . .",
    "w . . . . . . . . . w . .",
    "w w w w w w w w w w w . .",
    ". . . . . . . w . . . . .",
    ". . . . . . . w . w . . .",
    ". . . . . . . w . w w w w",
    ". . . . . . . w . . . . w",
    ". . . . . . . w w w w . .",
    ". p . . . . . . . . w w .",
    ". . . . . . . . . . . . .",
    ". . . . . . . . . . . . ."
  ]
]
